111111111111111
100002000000001
101010101010101
100000000000001
101010101010101
100000122000001
101010101010101
100000000000001
101010101010101
100000000000001
101010101010101
100000000000001
101010101010101
100000000000001
111111111111111