1111111111111111
1000000000000001
1000010101010101
1000000000000001
1000000000000001
1000000000000001
1000000000000001
1000000000000001
1000000000000001
1000000000000001
1000000000000001
1000000000000001
1000100011111001
1000100010000001
1000111111110001
1111111111111111