111111111111111
100003333300001
101310101013101
103330000033301
131310101013131
131310101013131
131310101013131
131310101013131
131310101013131
131310101013131
131310101013131
103330000033301
101310101013101
100003333300001
111111111111111