111111111111111
100033333330001
101313131313101
103333333333301
131313131313131
133333333333331
131313131313131
133333333333331
131313131313131
133333333333331
131313131313131
103333333333301
101313131313101
100033333330001
111111111111111