111111111111111
100333000333001
101313131313101
133333333333331
131313131313131
133333333333331
101313131313101
103333333333301
101313131313101
133333333333331
131313131313131
133333333333331
101313131313101
100333000333001
111111111111111