1111111111111111
1000000000000001
1001001001001001
1000000000000001
1111111111111111
1111111111111111
1011010000111101
1000010111111101
1011010000111101
1111110111111101
1111110000111101
1111111111111011
1111111111000111
1111111111111111
1111111111111111
1111111111111111